00000000000000000000000000000000010001#     #37x28 approx
00000000000000000000000000000000010000#
00000000000000000000000000000000010000#
00000000000000000000000000000000010000#
00000000000022222200000000000000012222#
00000000000000000000000000000000011111#
22000000000000000000000000000000011111#
11200000000000000000000022222222211111#
11120000000000000000000000000000000000#
11112000000000000000000000000000000000#
11111200000000000000220000000000000000#
11110000000000000000000000000000000000#
11100000000000000000000000000000000020#
11000000000000000000000000000000000000#
11000000000222222222222000000000000000#
11200000000000000000000000000020000000#
11120000000000000000000000000000000000#
11112000000000000000000000000000000200#
11111200000000000000000000000000000000#
11111122222000022222200000000000000000#
10000000000000000000000000000000002000#
10000000000000000000000020000000000000#
10000000000000000000000000000000000000#
10000000000000000000000000002000000000#
10000000000000000000000000000000000000#
10000000000000000000000000000000000022#
10000000000000000000000000000000002211#
12222222222222222222222222222222221111#


